111111111111111111111111
1E000C000C01000C000000P1
100011100001001111111101
11001110C0110C00C0000001
110011100011C01100011101
1000000C100001C000011111
111111111111111111111111
